11111111111111111111
1100C000000000000001
11P000V0E00000000001
1100C000000000000001
11111111111111111111
